7 8 
2
********
........
E.E.E.E.
.M.M.S.S
E.......
M.......
........
........
********
E...E...
M.....ES
SE......
........
........
........
........
